Akte	f	Akten
Bad	n	Bäder
Bart	m	Bärte
Bart	-	-
Besteck	n	Bestecke
Bier	n	Biere
Bier	-	-
Block	m	-
Block	-	-
Bratkartoffel	f	Bratkartoffeln
Brief	m	Briefe
Brot	n	Brote
Börse	f	Börsen
Ding	n	-
Ecke	f	Ecken
Garnele	f	Garnelen
Geschenk	n	Geschenke
Geschäft	n	Geschäfte
Hemd	n	Hemden
Hose	f	Hosen
Hund	m	Hunde
Hund	-	-
Hund	-	-
Idee	f	Ideen
Junge	m	-
Junge	-	-
Junge	-	-
Kanne	f	Kannen
Kleid	n	Kleider
Körper	m	Körper
Laden	m	-
Laden	n	-
Leute	-	Leute
Mitarbeiter	m	Mitarbeiter
Mädchen	n	Mädchen
Müll	m	-
Notiz	f	Notizen
Papier	n	Papiere
Politik	f	Politiken
Polizist	m	Polizisten
Pommes	-	Pommes
Post	f	Posten
Post	m	Posts
Rasierapparat	m	Rasierapparate
Sache	f	Sachen
Salat	m	Salate
Socke	f	Socken
Spiegel	m	Spiegel
Steak	n	Steaks
Tabelle	f	Tabellen
Tasche	f	Taschen
Tasse	f	Tassen
Text	m	Texte
Umschlag	m	Umschläge
Wagen	m	-
Wahnsinn	m	-
